
'''Only one Class which holds all attribute descriptions
'''
class Fielddescriptions(object):
    '''
    Beschreibung der CMF-Attribute
    '''
    TRAN = 'Transaction identification'
    TERM = 'Terminal identification'
    USERID = 'User identification'
    TTYPE = 'Transaction type'
    START = 'Task start time'
    STOP = 'Task stop time'
    TRANNUM = 'Transaction sequence number'
    TRANPRI = 'Transaction priority'
    TCLSNAME = 'Transaction class name'
    LUNAME = 'VTAM logical unit name'
    PGMNAME = 'First program name'
    NETUOWPX = 'Network Unit-of-Work Netname'
    NETUOWSX = 'Network Unit-of-Work Instance/Seqno'
    RSYSID = 'Remote sysid routed to'
    PERRECNT = 'Performance record count'
    RMUOWID = 'Recovery Manager Unit-of-Work id'
    SRVCLSNM = 'Workload Manager service class name'
    RPTCLSNM = 'Workload Manager report class name'
    FCTYNAME = 'Transaction Facility name'
    TRANFLAG = 'Transaction flags'
    TERMINFO = 'Terminal Information'
    TERMCONM = 'Terminal Connection name'
    BRDGTRAN = 'Bridge Transaction id'
    RRMSURID = 'RRMS/MVS Unit of Recovery id'
    PRCSNAME = 'Process name'
    PRCSTYPE = 'Process type'
    PRCSID = 'Process id'
    ACTVTYID = 'Activity id'
    ACTVTYNM = 'Activity name'
    CLIPADDR = 'Client IP Address'
    TRNGRPID = 'Transaction Group Id'
    NETID = 'Network id'
    RLUNAME = 'Real Luname'
    TCPSRVCE = 'TCP/IP Service name'
    PORTNUM = 'TCP/IP Service port number'
    OTSTID = 'OTS Transaction id'
    CBSRVRNM = 'CorbaServer name'
    CLIPPORT = 'Client IP Port'
    ISIPICNM = 'IPCONN name'
    ONETWKID = 'Originating networkid'
    OAPPLID = 'Originating applid'
    OSTART = 'Originating task start time'
    OTRANNUM = 'Originating transaction seq no'
    OTRAN = 'Originating transaction id'
    OUSERID = 'Originating userid'
    OUSERCOR = 'Originating user specific data'
    OTCPSVCE = 'Originating TCPIPSERVICE'
    OPORTNUM = 'Originating portnumber'
    OCLIPADR = 'Originating client IP address'
    OCLIPORT = 'Originating client portnumber'
    OTRANFLG = 'Originating transaction flags'
    OFCTYNME = 'Originating facility name'
    WBURIMNM = 'Urimap name'
    WBPIPLNM = 'Pipeline name'
    WBATMSNM = 'Atomservice name'
    WBSVCENM = 'Webservice name'
    WBSVOPNM = 'Webservice operation name'
    WBPROGNM = 'Program name'
    PHNTWKID = 'Previous Hop data networkid'
    PHAPPLID = 'Previous Hop data applid'
    PHSTART = 'Previous Hop data task start time'
    PHTRANNO = 'Previous Hop data trans seq no'
    OADATA3 = 'Originating adapter data 3'
    TASKFLAG = 'Transaction error flags'
    ABCODEO = 'Original Transaction abend codes'
    ABCODEC = 'Current Transaction abend code'
    RTYPE = 'Record type'
    TCMSGIN1 = 'Primary TC messages - in'
    TCCHRIN1 = 'Primary TC characters - in'
    TCMSGOU1 = 'Primary TC messages - out'
    TCCHROU1 = 'Primary TC characters - out'
    TCMSGIN2 = 'Secondary TC messages - in'
    TCCHRIN2 = 'Secondary TC characters - in'
    TCMSGOU2 = 'Secondary TC messages - out'
    TCCHROU2 = 'Secondary TC characters - out'
    TCM62IN2 = 'Secondary TC msgs for LU6.2. - in'
    TCC62IN2 = 'Secondary TC chars for LU6.2. - in'
    TCM62OU2 = 'Secondary TC msgs for LU6.2. - out'
    TCC62OU2 = 'Secondary TC chars for LU6.2. - out'
    TCALLOCT = 'No. TCTTE allocate requests'
    SCUGETCT = 'No. user storage getmains below line'
    SCCGETCT = 'No. CDSA storage getmains below line'
    SCUSRHWM = 'User task storage hwm below line'
    SC24CHWM = 'CDSA storage hwm below the line'
    SC31CHWM = 'ECDSA storage hwm above the line'
    SCUSRSTG = 'User task stge "occupancy" below line'
    SC24COCC = 'CDSA storage "occupancy" below line'
    SC31COCC = 'ECDSA storage "occupancy" above line'
    SC24SGCT = 'Shared stg getmain count below 16M'
    SC24GSHR = 'Shared stg bytes getmained'
    SC24FSHR = 'Shared stg bytes freemained'
    SC31SGCT = 'Shared stg getmain count above 16M'
    SC31GSHR = 'Shared stg bytes getmained'
    SC31FSHR = 'Shared stg bytes freemained'
    PCSTGHWM = 'Program storage hwm'
    PC31AHWM = 'Prog storage hwm above the line'
    PC24BHWM = 'Prog storage hwm below the line'
    PC31CHWM = 'ECDSA prog storage hwm above'
    PC24CHWM = 'CDSA prog storage hwm below'
    PC31RHWM = 'R/O prog storage hwm above'
    PC24RHWM = 'R/O prog storage hwm below'
    PC31SHWM = 'Shared prog storage hwm above'
    PC24SHWM = 'Shared prog storage hwm below'
    FCGETCT = 'No. file gets'
    FCPUTCT = 'No. file puts'
    FCBRWCT = 'No. file browses'
    FCADDCT = 'No. file adds'
    FCDELCT = 'No. file deletes'
    FCTOTCT = 'Total FC requests'
    FCAMCT = 'No. access method requests'
    FCVSWTT = 'FC waits for a VSAM string'
    FCXCWTT = 'FC waits for exclusive control of a VSAM CI'

    TDGETCT = 'No. transient data gets'
    TDPUTCT = 'No. transient data puts'
    TDPURCT = 'No. transient data purges'
    TDTOTCT = 'Total TD requests'
    TSGETCT = 'No. temp storage gets'
    TSPUTACT = 'No. temp storage puts - aux'
    TSPUTMCT = 'No. temp storage puts - main'
    TSTOTCT = 'Total TS requests'
    BMSMAPCT = 'No. BMS map requests'
    BMSINCT = 'No. BMS in requests'
    BMSOUTCT = 'No. BMS out requests'
    BMSTOTCT = 'Total BMS requests'
    PCLINKCT = 'No. program links'
    PCXCTLCT = 'No. program xctls'
    PCLOADCT = 'No. program loads'
    PCLURMCT = 'No. program links to URMs'
    PCDPLCT = 'No. DPL program links'
    PCDLCSDL = 'DPL program links with channel option data length'
    PCDLCRDL = 'DPL program returns with channel option data length'
    PCLNKCCT = 'No. program links with channel option'
    PCXCLCCT = 'No. program xctls with channel option'
    PCDPLCCT = 'DPL program links with channel option'
    PCRTNCCT = 'No. program returns with channel option'
    PCRTNCDL = 'No. program returns with channel option data length'
    JNLWRTCT = 'No. journal write requests'
    LOGWRTCT = 'No. CICS logger write requests'
    ICPUINCT = 'No. interval control starts'
    ICTOTCT = 'Total interval control requests'
    ICSTACCT = 'No. interval control start reqs with channel option'
    ICSTACDL = 'Interval control start reqs with channel option data length'
    ICSTRCCT = 'No. interval control start reqs with channel option - remote'
    ICSTRCDL = 'Interval control start reqs with channel option data length - remote'
    SPSYNCCT = 'No. syncpoint requests'
    CFCAPICT = 'No. OO Class Library API requests'
    SZALLOCT = 'No. FEPI allocates'
    SZRCVCT = 'No. FEPI receives'
    SZSENDCT = 'No. FEPI sends'
    SZSTRTCT = 'No. FEPI starts'
    SZCHROUT = 'No. chars sent vai FEPI'
    SZCHRIN = 'No. chars received via FEPI'
    SZALLCTO = 'No. FEPI allocate timeouts'
    SZRCVTO = 'No. FEPI receive timeouts'
    SZTOTCT = 'Total no. FEPI requests'
    BARSYNCT = 'No. Run Process/Activity Sync'
    BARASYCT = 'No. Run Process/Activity Async'
    BALKPACT = 'No. Link Process/Activity reqs'
    BADPROCT = 'No. Define Process requests'
    BADACTCT = 'No. Define Activity requests'
    BARSPACT = 'No. Reset Process/Activity requests'
    BASUPACT = 'No. Suspend Process/Activity requests'
    BARMPACT = 'No. Resume Process/Activity requests'
    BADCPACT = 'No. Delete Activity and Cancel Process or Activity requests'
    BAACQPCT = 'No. Acquire Process requests'
    BATOTPCT = 'Total No. Process/Activity requests'
    BAPRDCCT = 'No. Process Data Container requests'
    BAACDCCT = 'No. Activity Data Container requests'
    BATOTCCT = 'Total No. Data Container requests'
    BARATECT = 'No. Retrieve Reattach Event requests'
    BADFIECT = 'No. Define Input Event requests'
    BATIAECT = 'No. Timer Associated Event requests'
    BATOTECT = 'Total No. Event requests'
    WBRCVCT = 'No. WEB Receive requests'
    WBCHRIN = 'No. Characters received via WEB reqs'
    WBSENDCT = 'No. WEB Send requests'
    WBCHROUT = 'No. Characters sent via WEB requests'
    WBTOTCT = 'Total No. WEB requests'
    WBREPRCT = 'No. Repository Reads'
    WBREPWCT = 'No. Repository Writes'
    WBEXTRCT = 'No. WEB Extract requests'
    WBBRWCT = 'No. WEB Browse requests'
    WBREADCT = 'No. WEB Read requests'
    WBWRITET = 'No. WEB Write requests'
    DHCRECT = 'No. Document Create requests'
    DHINSCT = 'No. Document Insert requests'
    DHSETCT = 'No. Document Set requests'
    DHRETCT = 'No. Document Retrieve requests'
    DHDELCT = 'No. Document Delete requests'
    DHTOTCT = 'Total No. Document requests'
    DHTOTDCL = 'Total Document Created length'
    SOBYENCT = 'No. Bytes Encrypted'
    SOBYDECT = 'No. Bytes Decrypted'
    SOEXTRCT = 'No. Extract TCP/IP and Extract Certificate requests'
    SOCNPSCT = 'No. Create Non-Persistent Socket reqs'
    SOCPSCT = 'No. Create Persistent Socket reqs'
    SONPSHWM = 'Non-Persistent Socket HWM'
    SOPSHWM = 'Persistent Socket HWM'
    SORCVCT = 'No. Socket Receive requests'
    SOCHRIN = 'No. Characters received'
    SOSENDCT = 'No. Socket Send requests'
    SOCHROUT = 'No. Characters sent'
    SOTOTCT = 'Total No. Socket requests'
    SOMSGIN1 = 'No. Inbound Socket Receive reqs'
    SOCHRIN1 = 'No. Inbound Socket Characters recvd'
    SOMSGOU1 = 'No. Inbound Socket Send reqs'
    SOCHROU1 = 'No. Inbound Socket Characters sent'
    IMSREQCT = 'Total No. IMS requests'
    DB2REQCT = 'Total No. DB2 requests'
    WMQREQCT = 'Total No. WebSphere MQ requests'
    TCBATTCT = 'No. CICS Dispatcher TCB Attaches'
    DSTCBHWM = 'CICS Dispatcher TCB HWM'
    EJBSACCT = 'No. Bean State Activation requests'
    EJBSPACT = 'No. Bean State Passivation requests'
    EJBCRECT = 'No. Bean Creation requests'
    EJBREMCT = 'No. Bean Removal requests'
    EJBMTHCT = 'No. EJB Method Calls'
    EJBTOTCT = 'Total No. EJB requests'
    WBREDOCT = 'No. Web Read requests'
    WBWRTOCT = 'No. Web Write requests'
    WBRCVIN1 = 'No. Web Receive requests'
    WBCHRIN1 = 'No. Bytes received by Web reqs'
    WBSNDOU1 = 'No. Web Send requests'
    WBCHROU1 = 'No. Bytes sent by Web send reqs'
    WBPARSCT = 'No. Web Parse requests'
    WBBRWOCT = 'No. Web Browse requests'
    WBIWBSCT = 'No. Invoke Webservice requests'
    WBREPRDL = 'Repository Read data length'
    WBREPWDL = 'Repository Write data length'
    PGTOTCCT = 'Total No. channel data container reqs'
    PGBRWCCT = 'No. Browse container channel requests'
    PGGETCCT = 'No. Get container channel requests'
    PGPUTCCT = 'No. Put container channel requests'
    PGMOVCCT = 'No. Move container channel requests'
    PGGETCDL = 'Get container channel data length'
    PGPUTCDL = 'Put container channel data length'
    PGCRECCT = 'No. Containers created'
    PGCSTHWM = 'Container Storage HWM'
    ISALLOCT = 'No. IPCONN allocate requests'
    EICTOTCT = 'Total No. EXEC CICS requests'
    ECSIGECT = 'No. SIGNAL EVENT requests'
    ECEFOPCT = 'No. Event Filter operations'
    ECEVNTCT = 'No. EVENTs captured'
    ECSEVCCT = 'No. synchronous emission EVENTs'
    TIASKTCT = 'No. EXEC CICS ASKTIME requests'
    TITOTCT = 'Total No. EXEC     xxTIME reqs'
    BFDGSTCT = 'No. BIF DIGEST requests'
    BFTOTCT = 'Total No. BIF requests'
    MLXSSTDL = 'Total document length'
    MLXMLTCT = 'No. EXEC CICS TRANSFORM requests'
    WSACBLCT = 'No. WSACONTEXT BUILD requests'
    WSACGTCT = 'No. WSACONTEXT GET requests'
    WSAEPCCT = 'No. WSAEPR CREATE requests'
    WSATOTCT = 'Total No. WS-Addressing requests'
    WBSFCRCT = 'No. SOAPFAULT CREATE requests'
    WBSFTOCT = 'Total No. SOAPFAULT requests'
    WBISSFCT = 'No. INVOKE xxxSERVICE SOAP faults'
    WBSREQBL = 'SOAP request body length'
    WBSRSPBL = 'SOAP response body length'
    USRDISPT = 'User task Dispatch time'
    USRCPUT = 'User task Cpu time'
    SUSPTIME = 'Task Suspend time'
    DISPWTT = 'Dispatch Wait time'
    QRDISPT = 'User task QR Mode Dispatch time'
    QRCPUT = 'User task QR Mode Cpu time'
    MSDISPT = 'User task Other Mode Dispatch time'
    MSCPUT = 'User task Other Mode Cpu time'
    RODISPT = 'User task RO Mode Dispatch time'
    ROCPUT = 'User task RO Mode Cpu time'
    KY8DISPT = 'User task Key 8 Mode Dispatch time'
    KY8CPUT = 'User task Key 8 Mode Cpu time'
    KY9DISPT = 'User task Key 9 Mode Dispatch time'
    KY9CPUT = 'User task Key 9 Mode Cpu time'
    L8CPUT = 'User task L8 Mode Cpu time'
    L9CPUT = 'User task L9 Mode Cpu time'
    J8CPUT = 'User task J8 Mode Cpu time'
    S8CPUT = 'User task S8 Mode Cpu time'
    J9CPUT = 'User task J9 Mode Cpu time'
    X8CPUT = 'User task X8 Mode Cpu time'
    X9CPUT = 'User task X9 Mode Cpu time'
    T8CPUT = 'User task T8 Mode Cpu time'
    QRMODDLY = 'QR Mode delay time'
    MAXOTDLY = 'Max Open TCB delay time'
    MAXJTDLY = 'Max JVM TCB delay time'
    MAXXTDLY = 'Max XPLink TCB delay time'
    MAXSTDLY = 'Max SSL TCB delay time'
    MAXTTDLY = 'Max Thrd TCB delay time'
    DSTCBMWT = 'Dispatcher TCB Mismatch wait time'
    DSCHMDLY = 'CICS TCB Change Mode delay time'
    EXWTTIME = 'Exception wait time'
    TCIOWTT = 'TC i/o wait time'
    FCIOWTT = 'FC i/o wait time'
    JCIOWTT = 'JC i/o wait time'
    TSIOWTT = 'TS i/o wait time'
    IRIOWTT = 'IR i/o wait time'
    TDIOWTT = 'TD i/o wait time'
    PCLOADTM = 'Program load time'
    DSPDELAY = '1st Dispatch delay - TCLASSMXTetc'
    TCLDELAY = '1st Dispatch delay due to TCLASS'
    MXTDELAY = '1st Dispatch delay due to MXT'
    ENQDELAY = 'Local ENQ delay time'
    GNQDELAY = 'Global ENQ delay time'
    LU61WTT = 'LU61 i/o wait time'
    LU62WTT = 'LU62 i/o wait time'
    SZWAIT = 'FEPI suspend time'
    RMITIME = 'Total RMI elapsed time'
    RMISUSP = 'Total RMI suspend time'
    SYNCTIME = 'Syncpoint elapsed time'
    RLSWAIT = 'RLS wait time'
    RLSCPUT = 'RLS SRB CPU time'
    LMDELAY = 'Lock Mgr delay time'
    WTEXWAIT = 'Wait External wait time'
    WTCEWAIT = 'Wait CICS/Wait Event time'
    ICDELAY = 'Interval control delay time'
    GVUPWAIT = 'Give up control wait time'
    TSSHWAIT = 'Shared TS wait time'
    CFDTWAIT = 'CF Data Table wait time'
    SRVSYWTT = 'Server Syncpoint wait time'
    RRMSWAIT = 'RRMS/MVS wait time'
    RUNTRWTT = 'Run Transaction wait time'
    SYNCDLY = 'Syncpoint delay time'
    SOIOWTT = 'Socket I/O wait time'
    IMSWAIT = 'IMS wait time'
    DB2RDYQW = 'DB2 Readyq wait time'
    DB2CONWT = 'DB2 Connection wait time'
    DB2WAIT = 'DB2 wait time'
    WMQGETWT = 'WebSphere MQ Getwait wait time'
    JVMTIME = 'Total JVM elapsed time'
    JVMSUSP = 'Total JVM suspend time'
    SOOIOWTT = 'Outbound Socket I/O wait time'
    RQRWAIT = 'Request Receiver wait time'
    RQPWAIT = 'Request Processor wait time'
    OTSINDWT = 'OTS Indoubt wait time'
    JVMITIME = 'JVM elapsed time - initialise'
    JVMRTIME = 'JVM elapsed time - resetting'
    PTPWAIT = 'Partner wait time'
    DSMMSCWT = 'DS storage constraint wait time'
    ISIOWTT = 'IS IPCONN I/O wait time'
    MLXSSCTM = 'XML System Services CPU time'
    JVMTHDWT = 'JVMSERVER thread wait time'
    WMQASRBT = 'WebSphere MQ API SRB time'
    IDENT = 'ivv AID'
    IVASOUTC = 'Anzahl Outbound Calls'
    IVASOUTT = 'Bit-String - Outbound-Service'
    IVASOUTD = 'Outbound Time'
    IVASREQC = 'Anzahl ivas-Requests'
    IVASREQI = 'Benutzeraktion-Id'
    RESP = 'Differenz STOP START'
